R 1920 1080
F  220,221,121
NO ./path_to_the_north_texture
SO ./path_to_the_south_texture
WE ./path_to_the_west_texture
EA ./path_to _the_east_texture


S  ./path_to_the_sprite_texture
F  221,0,121   
C  225,30,0
1111111111111111111111111   
1000000000110000000000001
1011000001110000002000001
1001000000000000000000001
10000000001100000111011111111111111111
kk

